9,13,B
0000000000000
011111*111110
0111111111110
0111111111110
A22222222222C
0111111111110
0111111111110
0111111111110
0000000000000
*Pokeball
EOF